TP63	auto_regulate
ZNF263	no_feedback
NCOA3	auto_regulate
MYB	auto_regulate
SMC1A	no_feedback
ATF7	auto_regulate
TEAD4	auto_regulate
CBX3	no_feedback
ZNF384	auto_regulate
GTF3C2	no_feedback
PHF8	auto_regulate
TAF7	auto_regulate
SIX5	auto_regulate
SIN3A	auto_regulate
HDAC1	no_feedback
ETS1	auto_regulate
BMPR1A	no_feedback
RBBP5	no_feedback
MAF	no_feedback
ZFX	auto_regulate
TP53	auto_regulate
PBX2	no_feedback
SIN3B	auto_regulate
CBX1	auto_regulate
BCL3	auto_regulate
TCF3	auto_regulate
KDM4A	auto_regulate
AFF4	no_feedback
TFAP4	auto_regulate
EGLN2	auto_regulate
EBF1	auto_regulate
BRD1	no_feedback
FOXP2	auto_regulate
E2F4	no_feedback
NR1H2	no_feedback
BCL6	auto_regulate
NFE2L2	auto_regulate
GATA3	auto_regulate
KDM4B	auto_regulate
UBTF	auto_regulate
BHLHE40	auto_regulate
SMARCC1	auto_regulate
HSF1	auto_regulate
HMGN3	no_feedback
KDM4C	auto_regulate
SMAD1	no_feedback
KDM5A	auto_regulate
BCL11A	auto_regulate
CREB3L1	auto_regulate
CEBPD	auto_regulate
KLF6	auto_regulate
SREBF2	no_feedback
STAT3	auto_regulate
ZEB1	auto_regulate
FANCL	auto_regulate
THAP1	no_feedback
MAX	auto_regulate
BRD4	auto_regulate
CDK8	auto_regulate
CTCF	no_feedback
MXI1	auto_regulate
KDM5B	auto_regulate
NR2F1	no_feedback
SIRT6	no_feedback
MYC	auto_regulate
ZBED1	no_feedback
MYNN	no_feedback
ELF1	auto_regulate
SOX11	auto_regulate
TFAP2C	auto_regulate
SETDB1	no_feedback
E2F6	no_feedback
MBD2	auto_regulate
ERG	auto_regulate
POU5F1	auto_regulate
CTCFL	auto_regulate
HEXIM1	no_feedback
AR	auto_regulate
TCF12	auto_regulate
CBFB	auto_regulate
GATA6	no_feedback
GABPA	no_feedback
TRIM24	auto_regulate
REST	auto_regulate
CDK9	auto_regulate
ESR1	auto_regulate
PGR	auto_regulate
HIF1A	auto_regulate
ASCL1	no_feedback
EP300	no_feedback
ID3	auto_regulate
MED1	no_feedback
SNAI2	auto_regulate
SMARCB1	no_feedback
JARID2	no_feedback
ATF1	auto_regulate
DEK	auto_regulate
CREB1	auto_regulate
HDGF	auto_regulate
MTA3	auto_regulate
FOSL2	auto_regulate
ZKSCAN1	auto_regulate
SP1	auto_regulate
MNT	auto_regulate
TRIM22	auto_regulate
ZBTB7A	auto_regulate
MTA2	auto_regulate
HDAC8	auto_regulate
ZNF143	auto_regulate
HCFC1	auto_regulate
ZNF750	no_feedback
NFE2	auto_regulate
NOTCH1	auto_regulate
MYCN	auto_regulate
KLF4	auto_regulate
GATA4	auto_regulate
JUNB	no_feedback
YY1	auto_regulate
PRKDC	no_feedback
CDK7	no_feedback
TFAP2A	auto_regulate
MAZ	auto_regulate
ZBTB33	no_feedback
CHD2	no_feedback
RCOR1	auto_regulate
SMAD3	auto_regulate
FOXP1	auto_regulate
GFI1B	auto_regulate
RB1	no_feedback
HDAC2	no_feedback
NEUROD1	no_feedback
MAFF	no_feedback
ZMIZ1	auto_regulate
GTF2F1	no_feedback
TBL1XR1	auto_regulate
ZHX1	no_feedback
EED	auto_regulate
VDR	auto_regulate
ZNF175	no_feedback
NONO	no_feedback
KLF9	auto_regulate
NFIC	auto_regulate
SP4	auto_regulate
HBP1	auto_regulate
CTBP1	no_feedback
CUX1	auto_regulate
RNF2	no_feedback
NR2F2	auto_regulate
CREBBP	auto_regulate
TWIST1	no_feedback
MITF	auto_regulate
ELF3	auto_regulate
E2F1	auto_regulate
MTA1	no_feedback
BRD2	no_feedback
MBD3	auto_regulate
ETV1	auto_regulate
NRF1	no_feedback
KLF5	auto_regulate
NIPBL	no_feedback
MED26	auto_regulate
EGR1	auto_regulate
KDM1A	auto_regulate
HNF4G	auto_regulate
PRDM14	auto_regulate
ETV4	auto_regulate
JUND	auto_regulate
CHD1	auto_regulate
TCF7L2	auto_regulate
CREM	auto_regulate
MYOD1	auto_regulate
TBP	no_feedback
FOSL1	auto_regulate
JMJD1C	auto_regulate
DAXX	no_feedback
SAP30	auto_regulate
TAF3	no_feedback
RUNX2	auto_regulate
STAG1	auto_regulate
KDM6B	auto_regulate
EZH2	auto_regulate
PAX5	auto_regulate
POU2F2	auto_regulate
IRF2	auto_regulate
BACH1	auto_regulate
SREBF1	auto_regulate
SMAD5	auto_regulate
ZMYND11	no_feedback
NSD2	auto_regulate
GATA1	auto_regulate
LDB1	no_feedback
RUNX1	auto_regulate
TAL1	auto_regulate
TRIM28	no_feedback
E2F7	auto_regulate
NKX2-2	auto_regulate
NR3C1	auto_regulate
GATA2	auto_regulate
KLF1	auto_regulate
PIAS1	auto_regulate
ARNT	auto_regulate
CHD8	auto_regulate
BHLHE22	no_feedback
FOS	auto_regulate
SRF	auto_regulate
USF1	no_feedback
SPI1	auto_regulate
JUN	no_feedback
NKX2-1	auto_regulate
PKNOX1	auto_regulate
SMARCA4	auto_regulate
MEIS2	auto_regulate
DPF2	auto_regulate
DDX5	no_feedback
SMC3	no_feedback
RAD21	auto_regulate
MLLT1	auto_regulate
TARDBP	no_feedback
AHR	auto_regulate
ATF3	auto_regulate
KLF13	auto_regulate
FOXK2	auto_regulate
NFYA	no_feedback
BCLAF1	no_feedback
ELL2	auto_regulate
IRF4	auto_regulate
FOXO1	auto_regulate
EZH1	auto_regulate
ZHX2	auto_regulate
ADNP	auto_regulate
SP2	no_feedback
FLI1	auto_regulate
STAT1	auto_regulate
ESRRA	no_feedback
RARA	auto_regulate
CCNT2	no_feedback
USF2	no_feedback
MBD1	auto_regulate
RAD51	no_feedback
CTBP2	auto_regulate
TBL1X	auto_regulate
SOX6	auto_regulate
RFX5	no_feedback
NBN	auto_regulate
ATF2	auto_regulate
CEBPB	auto_regulate
BRCA1	auto_regulate
NFYB	no_feedback
TERF1	auto_regulate
ZFP36	auto_regulate
IRF1	auto_regulate
RELA	no_feedback
DNMT3B	no_feedback
TGIF2	auto_regulate
MAFK	no_feedback
TCF7	auto_regulate
SUZ12	no_feedback
TFDP1	no_feedback
HMBOX1	auto_regulate
OCA2	no_feedback
ARID3A	auto_regulate
XBP1	no_feedback
CEBPA	no_feedback
HNF4A	no_feedback
ARID1B	no_feedback
NME2	auto_regulate
PAX8	auto_regulate
MAFG	no_feedback
PML	auto_regulate
NFE2L1	no_feedback
STAT5A	no_feedback
ZNF24	auto_regulate
TEAD1	auto_regulate
CREB3	no_feedback
NFRKB	no_feedback
MIER1	auto_regulate
NR2C2	auto_regulate
DDX20	no_feedback
ZEB2	auto_regulate
NR4A1	no_feedback
IRF9	auto_regulate
ZBTB11	no_feedback
ZNF274	auto_regulate
ZNF639	no_feedback
IKZF1	auto_regulate
ZNF197	no_feedback
PPARG	auto_regulate
STAT2	auto_regulate
ZNF644	auto_regulate
L3MBTL2	no_feedback
E2F5	no_feedback
DIDO1	auto_regulate
RBPJ	auto_regulate
CSNK2A1	no_feedback
POU4F2	auto_regulate
ZBTB16	auto_regulate
SNAPC1	no_feedback
PYGO2	no_feedback
CDK6	auto_regulate
ARNTL	no_feedback
TAF1	auto_regulate
FOXA1	auto_regulate
FOXA2	no_feedback
NANOG	no_feedback
ARID2	auto_regulate
ARID1A	auto_regulate
NFATC1	auto_regulate
SFMBT1	no_feedback
TOP1	auto_regulate
LMO2	auto_regulate
GLYR1	auto_regulate
NCOA2	auto_regulate
NCOR2	auto_regulate
MAFB	no_feedback
PALB2	no_feedback
ELF5	no_feedback
RUNX3	auto_regulate
BATF	auto_regulate
RFX1	auto_regulate
GATAD1	no_feedback
FOXM1	no_feedback
CHD7	no_feedback
RUNX1T1	no_feedback
ASXL1	no_feedback
TBX21	auto_regulate
NELFA	auto_regulate
RELB	auto_regulate
ETV6	auto_regulate
MEF2A	auto_regulate
SNAPC4	no_feedback
SIX2	no_feedback
PDX1	auto_regulate
SPIB	auto_regulate
SOX9	no_feedback
GRHL2	auto_regulate
CBFA2T2	auto_regulate
TERF2	auto_regulate
ARRB1	auto_regulate
NKX3-1	auto_regulate
STAT5B	no_feedback
NRIP1	auto_regulate
PBX3	auto_regulate
TLE3	auto_regulate
RAC3	no_feedback
TCF4	no_feedback
ZNF207	no_feedback
GTF2B	no_feedback
RXRA	auto_regulate
CDX2	auto_regulate
ELK1	auto_regulate
LYL1	auto_regulate
CTNNB1	no_feedback
RFX2	no_feedback
KAT2B	no_feedback
NR2F6	auto_regulate
CXXC4	no_feedback
TAF2	auto_regulate
SUPT20H	no_feedback
SOX2	auto_regulate
ATRX	no_feedback
SOX13	no_feedback
SSRP1	no_feedback
MYBL2	no_feedback
NFKB1	auto_regulate
BCOR	auto_regulate
PAX6	no_feedback
ZC3H11A	no_feedback
CIITA	auto_regulate
ASH2L	no_feedback
NFKB2	auto_regulate
EPAS1	no_feedback
FOXK1	auto_regulate
RBP2	no_feedback
POU2F1	auto_regulate
UCREBBP	no_feedback
PROX1	auto_regulate
TSC22D4	no_feedback
T	auto_regulate
NCOA1	auto_regulate
CBX2	no_feedback
CLOCK	no_feedback
CRY1	no_feedback
ZNF92	no_feedback
TP73	auto_regulate
JMJD6	auto_regulate
TCF25	no_feedback
GSPT2	no_feedback
ZNF766	no_feedback
BRF2	no_feedback
BRD3	auto_regulate
DEAF1	no_feedback
KMT2A	auto_regulate
BACH2	auto_regulate
HOXB13	auto_regulate
HNF1B	no_feedback
SND1	auto_regulate
UBN1	no_feedback
ESR2	no_feedback
ONECUT1	auto_regulate
PCGF2	no_feedback
ZNF740	no_feedback
USP7	no_feedback
ZNF165	no_feedback
CEBPG	auto_regulate
ELK4	no_feedback
SATB1	no_feedback
MEIS1	auto_regulate
ZNF318	no_feedback
ZC3H8	no_feedback
IRF3	no_feedback
CEBPZ	no_feedback
ZNF589	no_feedback
PPARGC1A	no_feedback
NFKBIA	auto_regulate
BMI1	auto_regulate
BDP1	no_feedback
SMARCC2	no_feedback
RYBP	no_feedback
YAP1	auto_regulate
ZNF217	auto_regulate
HDAC6	no_feedback
BRF1	no_feedback
KMT2B	no_feedback
NR5A2	no_feedback
OTX2	no_feedback
LHX2	auto_regulate
SOX10	no_feedback
HOXA9	no_feedback
EOMES	auto_regulate
HINFP	no_feedback
SMAD4	no_feedback
WRNIP1	no_feedback
CBX4	no_feedback
HHEX	no_feedback
ATF4	no_feedback
EHF	no_feedback
MEF2C	auto_regulate
CDK2	no_feedback
MEF2B	no_feedback
ZZZ3	no_feedback
PTTG1	no_feedback
BAHD1	no_feedback
SMAD2	auto_regulate
ZNF584	no_feedback
ZNF83	no_feedback
MAML3	no_feedback
NCOR1	no_feedback
LEF1	no_feedback
CHD4	no_feedback
PRDM1	no_feedback
DUX4	no_feedback
ILK	no_feedback
MBD4	no_feedback
ICE2	no_feedback
HOXB7	no_feedback
HDAC3	no_feedback
SGF29	auto_regulate
HES1	no_feedback
FOXJ2	no_feedback
ICE1	no_feedback
TEAD2	no_feedback
KLF3	no_feedback
CARM1	no_feedback
MLLT3	no_feedback
ELL	no_feedback
ZNF592	no_feedback
NR1H3	no_feedback
THAP11	no_feedback
C17orf49	no_feedback
SIRT3	no_feedback
KAT2A	no_feedback
ZNF335	no_feedback
MDM2	no_feedback
EWSR1	no_feedback
KDM1B	no_feedback
HOXC11	no_feedback
SVIL	auto_regulate
SMC4	no_feedback
TRRAP	auto_regulate
